8 28
|--------------------------|
|.P........|..............@|
|...|---.....|---..........|
|FFF|P.......|.............|
|................---.......|
|FF....---...........|----.|
|..F.......|.........|P....|
|--------------------------|
